...@.....
.........
#########
%%%%%%%%%
%%%%%%%%%
%%%%%%%%%
%%%%%%%%%
%%%%%%%%%
%%%%%%%%%
